1. A rule or piece of information used in or enabling problem - solving or
2. (Literary) A lighthearted medley of well - known tunes.
a marriage or mock an unpopular person.A series of discordant noises.Laissezpasser - A document allowing the holder to pass; a permit.
Abbozzo - a rough drawing or model
Abecedary - The alphabet, written out in a teaching book, or carved on a wall; a primer.
Ablution - The act of washing oneself (often used for humorously formal effect).
Abstemious - Indulging only very moderately in something, especially food and drink.
Abstuse - Difficult to understand; obscure.
Accouchement - The process of giving birth to a baby.
Accouter - Clothe or equip in something noticeable or impressive.
Accreditation - The action or process of officially recognizing someone as having a particular status or being qualified to perform a particular activity.
Acedia - Spiritual or mental sloth; apathy
Acerbic - 1. (Especially of a comment or style of speaking) Sharp and forthright.2. Tasting sour or bitter.
Acervation - building up into a pile or heap- a mass
Acrological - Relating to or based on initial letters or sounds.
Acutance - The sharpness of a photographic or printed image
Adagio - Performed in slow time.
Adhocracy - A flexible, adaptable, and informal organizational structure without Bureaucratic policies or procedures
Adiaphorous - Neither harmful nor beneficial.
Adjudicate - Make a formal judgment or decision about a problem or disputed matter.
Adroit - Clever or skillful in using the hands or mind
Adscititious - forming an addition or supplement; not integral or intrinsic
Adumbrate - foreshadow or symbolize
Adynaton - A form of hyperbole that uses exaggeration so magnified as to express impossibility; an instance of such hyperbole.
Aegis - The protection, backing, or support of a particular person or organization.
Aerie - A large nest of a bird of prey, especially an eagle, typically built high in a tree or on a cliff.
Aesculapian - relating to physician or medicine
Afflatus - A divine creative impulse or inspiration.
Agglomerate - Collect or form into a mass or group.
Aglet - A metal or plastic tube fixed tightly round each end of a shoelace.
Aide - memoire -An aid to the memory, especially a book or document
Ailurophile - a cat lover
Alacrity - brisk cheerful readiness
Alembic - A distilling apparatus, now obsolete, consisting of a rounded, necked flask and a cap with a long beak for condensing and conveying the products to a receiver.
Alliaceous - pertaining to onions and other alliums
Allocution - giving a formal speech or warning
Alluvium - A deposit of clay, silt, sand, and gravel left by flowing streams in a river valley or delta, typically producing fertile soil.
Alpenglow - the rosy light of the setting or rising sun seen on high mountains.
Ambigrams - typographical designs that allow words or phrases to be read in multiple orientations, often showcasing the designer’s creativity.
Ambisinister - Awkward or clumsy with both hands
Ambrosia - Something very pleasing to taste or smell.
Ambsace - lowest throw in dice, bad luck
Amour Propre - A sense of one's own worth; self-respect.
Amphigory - 1. A nonsense verse; a rigmarole, which is meaningless despite possibly appearing to have meaning.
Anacoluthon - A sentence or construction in which the expected grammatical sequence is absent; for example, "While in the garden, the door banged shut."
Anadromous - (Of a fish such as the salmon) Migrating up rivers from the sea to spawn.
Analog - Relating to or using signals or information represented by a continuously variable physical quantity such as spatial position, voltage, etc. (often contrasted with digital).
Andiron - A metal support, typically one of a pair, that holds wood burning in a fireplace
Andragogy - The method and practice of teaching adult learners; adult education.
Anent - concerning or about
Anfractuous - Sinuous or circuitous
Anima - (In Jungian psychology) The feminine part of a man's personality. 2. (Philosophy) The soul, especially the irrational part of the soul, as distinguished from the rational mind.
Annatto - fruit pulp for fabric dye
Anneal - heat slowly and let cool
Anodyne - not likely to cause offence or disagreement and somewhat dull.
Anomalous - deviate from a standard
Anon - Soon; shortly.
Anschauung - Philosophy, Kantianism) Sense-perception.
Antediluvian - ancient
Antepenultimate - Last but two in a series; third last.
Anthropic principal - strong and weak
Anthropogot - a bird with a human like tongue, so they can talk, parrot
Antimeria - 1. The use of a word from one word class or part of speech as if it were from another; in English typically the use of a noun as if it were a verb.
Antinomy - A contradiction between two beliefs or conclusions that are in themselves reasonable; a paradox.
Apercu - A comment or brief reference that makes an illuminating or entertaining point.
Aperitif - An alcoholic drink taken before a meal to stimulate the appetite.
Aphorism - a pithy observation that contains some truth.
Aphyllous - having no leaves
Apiary - place where bees are kept; a collection of beehives.
Aplomb - Self-confidence or assurance, especially when in a demanding situation.
Apodeictic - clearly established
Apodictic - Clearly established or beyond dispute
Apogee - highest point of development
Apollonian - relating to the Greek god Apollo
Apologue - moral fable, especially one with animals as characters.
Apoplexy - bleeding into an organ or loss of blood flow to an organ
Aporia - The expression of doubt.
Aposematic - Of coloration or markings) Serving to warn or repel predators.
Aposiopesis - The device of suddenly breaking off in speech
Apotheosis - The highest point in the development of something; culmination or climax or The elevation of someone to divine status; deification
Apparatchik - member of a political party
Appellation - The action of giving a name to someone or something
Appetency - A longing or Desire
Appropinquate - to approach
Appurtenance - An accessory or other item associated with a particular activity or style of living.
Apricate - To bask in the sun.
Aquiver - Quivering; trembling
Arable - land suitable enough to grow crops Teleological
arbiter - settles disputes or an authority
Arborist - A tree surgeon
Arcane - understood by few; mysterious or secret
Archetype - A very typical example of a certain person or thing.
Arcuate - Shaped like a bow, curved.
Ardent - Enthusiastic or passionate.2. (Literary) Burning; glowing.
Areanacous - consisting of sand
Argillacious - rocks Consisting of or containing clay
Argle - bargle-Copious but meaningless talk or writing; nonsense.
Argot - The jargon or slang of a particular group or class.
Arguendo - (Law) For the sake of argument; identifying the premises of a hypothetical argument while making it clear that no finding is being made on whether the premises are true.
Armamentarium - The medicines, equipment, and techniques available to a medical practitioner.2. A collection of resources available for a certain purpose.
Arras - A rich tapestry, typically hung on the walls of a room or used to conceal an alcove.
Arriere - Penske- a concealed thought or ulterior motive
Articulate - find the words
Assay - Determine the content or quality of (a metal or ore).
Assoil - to forgive
Astern - Behind or toward the rear of a ship or aircraft.
Astrolatry - The worship of stars and other celestial objects.
Asymptotic - describing limiting behavior in mathematics
Asyndeton - The omission or absence of a conjunction between parts of a sentence
Ataraxy - serene calmness
Atavistic - characterized by reversion to something ancestral
Atemporal - Existing or considered without relation to time
Attenuate - Reduce the force, effect, or value of
Atticism - a word or form characteristic from attic greek or Ancient Greek
Attornment - The formal transference of something to someone else.
Aureate - Highly ornamented or elaborate.
Auricle - Relating to the ear or hearing. 2. Relating to or shaped like an auricle.
Auspice - divine or prophetic token.
Auteur - A filmmaker whose personal influence and artistic control over a movie are so great that the filmmaker is regarded as the author of the movie.
Autodidact - a self-taught person
Autogenous - Arising from within or from a thing itself.
Autoschediastic - Impromptu, improvised, ex tempore or offhand.
Avatar - An icon or figure representing a particular person in video games, internet forums, etc.
Aver - State or assert to be the case.
Avidity - Extreme eagerness or enthusiasm
Avouch - Affirm or assert.
Axiomatic - Self-evident or unquestionable.
Badinage - Humorous or witty conversation.
Bailiwick - One's sphere of operations or particular area of interest.
Baize - coarse, typically green woolen material resembling felt, used for covering billiard and card tables.
Balaclava - A close-fitting garment covering the whole head and neck except for parts of the face, typically made of wool.
Banausic - Not operating on a refined or elevated level; mundane.
Baroque - European architecture, music, and art of the 17th and 18th centuries that followed mannerism and is characterized by ornate detail.
Basilisk - A mythical reptile with a lethal gaze or breath, hatched by a serpent from a cock's egg. 2. A long, slender, and mainly bright green lizard found in Central America, the male of which has a crest running from the head to the tail. It can swim well, and is able to run on its hind legs across the surface of water.
basket - like rackets fastened to the hand.
Beadle - A ceremonial officer of a church, college, or similar institution.
Beastie - an animal, insect or germ
Beau Geste - a noble and generous act.
Bechamel - A rich white sauce made with milk infused with herbs and other flavourings.
Bedight - adorned
Bedizen - Dress up or decorate gaudily
Bedlam - an old woman
Bel - Sprit- a witty person
Belgard - a loving affectionate glance
Bellicose - Demonstrating aggression and willingness to fight.Chef-de-oeuvre-A masterpiece
Benefic - Beneficent or kindly
Benison - A blessing
Bento - A lacquered or decorated wooden Japanese lunch box.
Bergamot - an oily substance extracted from the rind of the fruit of a dwarf variety of the Seville orange tree. It is used in cosmetics and as flavoring in tea.
Bespoke - something made for a particular person
Betide - literal happening
Betise - A foolish or ill-timed remark or action
Betoken - Be a sign of; indicate.2. Be a warning or indication of (a future event).
Bibelot - A small, decorative ornament or trinket.
Bibliophile - a person who loves collecting books
Biennial - every two years
Bijou - A jewel or trinket.
Bildungsroman - A novel dealing with one person's formative years or spiritual education.
Biophilia - love of nature
Biota - The animal and plant life of a particular region, habitat, or geological period.
Bissextile - an extra day, a leap year
Blandishment - (Usually "blandishments") A flattering or pleasing statement or action used to persuade someone gently to do something.
Blarney - Talk that aims to charm, pleasantly flatter, or persuade.
Blatherskite - A person who talks at great length without making much sense.
Blithesome - Of a person) Having a cheerful disposition.
Bocce - An Italian game similar to lawn bowling but played on a shorter, narrower green.
Boffo - a theatrical production or movie, or a review of one) Very successful or wholeheartedly commendatory or Boisterously funny.
Bokeh - The visual quality of the out-of-focus areas of a photographic image, especially as rendered by a particular lens
Bolide - large meteor which explodes in the atmosphere.
Bombinate - buzz or hum
Bon Vivant - A person who enjoys a sociable and luxurious lifestyle.
Bonhomie - genial, cheerful friendliness
Borborygmus - rumbling or gurgling noise made by the movement of fluid and gas in the intestines.
Borek - envelope of thin pastry filled with cheese, spinach, or ground meat and baked or fried.
Bosky - Wooded; covered by trees or bushes.
Boswell - A person who accompanies another and records their life.
Bravura - Great technical skill and brilliance shown in a performance or activity
Breviloquent - writing, Using very few words; concise.
Brobdingnagian - gigantic
Bromide - A trite and unoriginal idea or remark, typically intended to soothe or placate.2. A compound of bromine with another element or group, especially a salt containing the anion Br− or an organic compound with bromine bonded to an alkyl radical.3. A sedative preparation containing potassium bromide.4. A reproduction or piece of typesetting on bromide paper.
Brunoise - Finely diced vegetables that are cooked in butter and used to flavor soups and sauces.
Brusque - Abrupt or offhand in speech or manner.
BuckRam - Coarse linen or other cloth stiffened with gum or paste, and used as interfacing and in bookbinding.
Burgher - citizen of a town or city, typically a member of the wealthy bourgeoisie
Burnish - Enhance or perfect (something such as a reputation or a skill)
Buskin - high leather boot
Buttle - (Humorous) Work as a butler.
Béchamel - A rich white sauce made with milk infused with herbs and other flavorings.
Cacoethes - An urge to do something inadvisable
Cacophony - a harsh mixture of sounds
Cadre - A small group of people specially trained for a particular purpose or profession.
Caducous - Of an organ or part) Easily detached and shed at an early stage.
Caesura - a pause in a line. Interruption or break
Caligineous - misty, dark, obscure
Caliginous - Misty, dim; obscure, dark.
Calliope - A keyboard instrument resembling an organ but with the notes produced by steam whistles, used chiefly on showboats and in traveling fairs.
Calumny - spreading lies to spoil someone s reputation
Campanology - The art or practice of bell-ringing.
Canard - unfounded rumor or story
Canonical - literary or artistic work belonging to an artist
Canorous - melodious or resonant
Cantillate - chant or intone
Capricious - Given to sudden and unaccountable changes of mood or behaviour.
Carapace - tortoise shell
Carte Blanche - Complete freedom to act as one wishes or thinks best.
Cartomancy - Fortunetelling by interpreting a random selection of playing cards.
Casus belli - cause for war
Casus Foederis - cause for the alliance
Catachresis - The use of a word in a way that is not correct
Catastasis - The third part of an ancient Greek drama, in which the action is heightened for the catastrophe.
Cathexis - The concentration of mental energy on one particular person, idea, or object (especially to an unhealthy degree).
Causerie - an informal article or talk of a literary subject
Cavdlcade - formal procession of people walking, on horseback, or riding in vehicles.
Cavil - Make petty or unnecessary objections.
Cavort - jump around excited
Celerity - swiftness of movement
Cenacle - discussion group or literary group
Cenatory - related to dinner
Censorious - severely critical of others
Centenary - Relating to a hundredth anniversary; centennial.
Cetology - The branch of zoology that deals with whales, dolphins, and porpoises
Chagrin - Distress or embarrassment at having failed or been humiliated
Chambray - A linen-finished gingham cloth with a white weft and a colored warp, producing a mottled appearance.
chanteuse - A female singer of popular songs, especially in a nightclub.
Chaparral - Vegetation consisting chiefly of tangled shrubs and thorny bushes.
Charente - pow wow
Charivari - A noisy mock serenade performed by a group of people to celebrate
Charybdis - dangerous whirlpool in a narrow channel of the sea, opposite the cave of the sea monster Scylla
Chatreuse - A pale green or yellow liqueur made from brandy and aromatic herbs.
Chautauqua - (North American) An institution that provided popular adult education courses and entertainment in the late 19th and early 20th centuries.
Chilliad - a group of 1000 things
Chthonic - Concerning, belonging to, or inhabiting the underworld
Cicatrix - a scar
Cipher - A secret or disguised way of writing; a code.
Circumlocution - The use of many words where fewer would do, especially in a deliberate attempt to be vague or evasive.
Circumstellar - That surrounds, or revolves around a star.
Clarisy - A distinct class of learned or literary people.
Clepsydra - an ancient time measuring device involving the flow of water
Clinquant - tinsel
Cloister - A convent or monastery
Cloven - Split or divided in two
Coda - A concluding event, remark, or section.
Codex - An ancient manuscript text in book form
Coeval - a contemporary
Cogitate - Think deeply about something; meditate or reflect.
Cognomen - A name or nickname.A third personal name given to an ancient Roman citizen, typically passed down from father to son, for example Marcus Tullius "Cicero.
Cognoscente - a connoisseur, an expert
Collogue - Talk confidentially or conspiratorially.
Collywobbles - stomach queasiness
Compeer - same rank or equal
Compendious - Containing or presenting the essential facts of something in a comprehensive but concise way. Internal
Compere - A person who introduces the performers or contestants in a variety show; host.Act as a compère for (such a show)
Complaisant - Willing to please others; obliging; agreeable.
Comport - conduct oneself; behave.
Conation - The mental faculty of purpose, desire, or will to perform an action; volition.
Concomitant - naturally associated
Concord - Agreement or harmony between people or groups.
Confrere - a colleague
Confute - Prove (a person or an assertion) to be wrong.
Congruent - in agreement or harmony
Congruous - In agreement or Harmony
Conlang - A language that has been artificially created; a constructed language.
Connate - Especially of ideas or principles) Existing in a person or thing from birth; innate.
Consanguineous - Relating to or denoting people descended from the same ancestor.
consanguineous - Relating to or denoting people descended from the same ancestor.
Consentient - Of the same opinion in a matter; in agreement
Conspectus - A summary or overview of a subject
Constitutive - Forming an essential element of something.
Contranym - A word with two opposite meanings, e.g., "sanction" (which can mean both "a penalty for disobeying a law" and "official permission or approval
Contretemps - minor dispute or disagreement.2. An unexpected and unfortunate occurrence.
Contronym - A word with two opposite meanings, e.g., "sanction" (which can mean both "a penalty for disobeying a law" and "official permission or approval for an action").
Convivial - 1. (Of an atmosphere or event) Friendly, lively, and enjoyable.2. (Of a person) Cheerful and friendly; jovial.
Copse - A small group of trees.
Coriaceous - Resembling or having the texture of leather.
Corpus - collection of written texts, especially the entire works of a particular author or a body of writing on a particular subject.
Corrigendum - thing to be corrected, typically an error in a printed book.
Cortège - funeral procession or entourage
Coruscate - flash or sparkle
Coruscation - A flash or sparkle of light.
Corvine - Of or like a raven or crow, especially in color
Corybantic - frenzied, wild
Cosset - overprotected in a gross way
Coterie - a small group with same purpose
Counterpane - a bedspread
Crabwise - o, toward, or from the side, typically in an awkward way.
Craic - enjoyable social event
Cranium - crankum- Elaborate decoration or detail.
Craquelure - network of cracks in pavement or varnish
Craven - lacking courage
Credence - belief in something
Crenellations - The battlements of a castle or other building.
Crepitate - Make a crackling sound.
Crepuscular - relating to twilight
Cruciverbalist - person who enjoys or is skilled at solving crosswords.
Cryptonym - A code name.
Csardas - a Hungarian dance that starts slow and gets faster
Culpable - deserving blame
Cultivar - A plant variety that has been produced in cultivation by selective breeding. Cultivars are usually designated in the style Taxus baccata "Variegata."
Cumbrous - Literary term for cumbersome
Cupable - Deserving blame
Curvet - graceful or energetic leap.
Cynosure - A person or thing that is the center of attention or admiration
Dactylonomy - The practice of counting on one’s fingers, or otherwise representing numbers with one’s fingers.
Dada - An early 20th-century international movement in art, literature, music, and film, repudiating and mocking artistic and social conventions and emphasizing the illogical and absurd
Daedal - Skillful, cunning, or inventive.
Daedalian - Ingeniously or cunningly designed; artistic, ingenious, intricate. 2. Difficult to comprehend due to complexity or intricacy.
Daedel - skillful, cunning
Dardalian - Ingeniously or cunningly designed; artistic, ingenious, intricate
Darg - a days work
Dauntless - Characterized by long words; long-winded.
Deasil - e sun's apparent course, considered as lucky; clockwise.
Decapod - crustacean of the order Decapoda, such as a shrimp, crab, or lobster.
decision - making. 2. (Heuristics) The study and use of Heuristics techniques
Declivity - A downward slope
Decoct - Extract the essence from (something) by heating or boiling it.
Decoction - The liquor resulting from concentrating the essence of a substance by heating or boiling, especially a medicinal preparation made from a plant.
Decorticate - remove the bark, rind or husk from
Deedy - industrious
Deglutition - The action or process of swallowing.
Degust - Taste (something) carefully, so as to appreciate it fully.
Dekko - a quick look or glance
Delectation - Pleasure and delight.
Delphic - Deliberately obscure or ambiguous.
Demarche - political initiative
Demitasse - a cup of coffee
Demiurge - A being responsible for the creation of the universe.
Demonym - A noun used to denote the natives or inhabitants of a particular country, state, city, etc.
Demur - Raise doubts or objections or show reluctance.
Denouement - The final part of a play, movie, or narrative in which the strands of the plot are drawn together and matters are explained or resolved.
Deontology - The study of the nature of duty and obligation.
Depute - Appoint or instruct (someone) to perform a task for which one is responsible.
Deracinate - Uproot (someone) from their natural geographical, social, or cultural environment.
Derecho - line of intense, widespread, and fast-moving windstorms and sometimes thunderstorms that moves across a great distance and is characterized by damaging winds
Derision - contemptuous ridicule or mockery.
Dernier cri - latest fashion
Derring - do- action of heroic courage
Descant - An independent treble melody usually sung or played above a basic melody.2. (Literary) A melodious song.3. A discourse on a theme or subject.
Descry - catch site of
Desideratum - something that is wanted
Desultory - unfocused
Deuteragonist - The person second in importance to the protagonist in a drama.
Devoir - A person's duty.
Diapason - An organ stop sounding a main register of flue pipes, typically of
Diaphanous - light, delicate, translucent
Dido - a michevious prank
Diegesis - a plot or narrative in a movie
Dieresis - a mark placed over a vowel to indicate a sound made over two vowels like Brontë
Dight - clothes or equipped
Dilatory - slow to act
Diphthong - A sound formed by the combination of two vowels in a single syllable, in which the sound begins as one vowel and moves toward another (as in "coin," "loud," and "side")
Discursive - digressing from subject to subject
Disembogue - Of a river or stream) Emerge or be discharged into the sea or a larger river.
Disport - Enjoy oneself unrestrainedly; frolic.
Disquisition - A long or elaborate essay or discussion on a particular subject.
Divaricate - Stretch or spread apart; diverge widely.
Doctrine - A belief or set of beliefs held and taught by a church, political party, or other group.
Docusoap - A documentary following people in a particular occupation or location over a period of time.
Doggerel - Comic verse composed in irregular rhythm.
Dolorifuge - something that mitigates or removes grief
Donnybrook - scene of uproar and disorder; a heated argument.
Dorgi - dog that is bred as a cross between a dachshund and a Welsh corgi.
Dorodango - A Japanese art form in which earth and water are molded to create a delicate shiny sphere resembling a billiard ball.
Dragoman - Persian or Arabic interpreter or guide
Dramaturgy - practice of dramatic composition.
Dramedy - A movie, play, or broadcast program that combines elements of drama and comedy.
Dromedary - one humped camel for racing
Dryasdust - A boring, pedantic speaker or writer.
Dubious - not to be relied on;suspect
Ductile - a metal able to be drawn out into a wire
Duende - A quality of passion and inspiration or A supernatural being or spirit resembling a pixie or imp.
Dunnage - luggage brought aboard a ship
Dyad - consists of two elements
Dynamism - The quality of being characterized by vigorous activity and progress
Dysania - A state of finding it hard to get out of bed in the morning.
Eau De Nil - A pale greenish color
Ebullient - cheerful or boiling with energy
Ebullition - The action of bubbling or boiling.
Echt - Authentic and typical.
Edacious - Relating to or given to eating.
EdificationAntediluvian - Of or belonging to the time before the biblical flood
Edifice - A building, especially a large, imposing one.
Edify - Instruct or improve (someone) morally or intellectually.
Efficacious - (Of something inanimate or abstract) Successful in producing a desired or intended result; effective.
Efficacy - ability to get desired results
Effloresce - reach optimum stage of blossom
Efflux - The flowing out of a particular substance or particle.
Effulgence - Shining brightly; radiant.
Eggcorn - word or phrase that results from a mishearing or misinterpretation of another, an element of the original being substituted for one that sounds very similar or identical (e.g., "tow the line" instead of "toe the line")
Eidetic - Relating to or denoting mental images having unusual vividness and detail, as if actually visible.
Eidolon - An idealised person or thing.A spectre or phantom.
Eigengrau - The dark gray color seen by the eyes in perfect darkness as a result of signals from the optic nerves.
eight - foot pitch. A grand swelling burst of harmony.
Eirenicon - a proposal to resolve disputes and bring peace, establish unit
Eldritch - weird, sinister, ghostly
Elflocks - A tangled mass of hair.
Elide - omit a vowel or join together
Elucidate - make things clear
Emancipation - The fact or process of being set free from legal, social, or political restrictions; liberation.2.The freeing of someone from slavery.
Emblematize - serve as a symbol
Embolalia - Automatic speech; verbalization that occurs without conscious effort by the individual, such as repetitions and filler words.
Emeritas - (Of the former holder of an office, especially a college professor) Having retired but allowed to retain their title as an honor.
Emeritus - Of the former holder of an office, especially a college professor) Having retired but allowed to retain their title as an honor.
Emolument - A salary, fee, or profit from employment or office.
Empirical - based on experience rather than theory
Empyrean - Relating to heaven or the sky
Emulous - Seeking to emulate someone or something
Enchiridion - a book containing essential information on a subject
Encomium - A speech or piece of writing that praises someone or something highly.
Endogenous - Having an internal cause or origin
Endue - endowed with a quality or ability
Enjambment - The continuation of a sentence without a pause beyond the end of a line, couplet, or stanza.
Ennead - A group or set of nine.
Ensorcell - enchant or fascinate
Entelechy - The realisation of potential.
Entre nous - Between ourselves; privately.
Entrements - A light dish served between two courses of a formal meal.
Envoi - an authors concluding word or a lyrical stanza or piano piece
Epergne - A n ornamental centerpiece for a dining table, typically used for holding fruit or flowers.
Epexegesis - The addition of words to clarify meaning..Words added for the purpose of clarifying meaning.
Ephemera - things that are enjoyed temporarily
Ephemeral - Lasting for a very short time
Epigrammatic - Of the nature or in the style of an epigram; concise, clever, and amusing.
Epigraph - An inscription on a building, statue, or coin. A short quotation or saying at the beginning of a book or chapter, intended to suggest its theme.
Epiphenomenon - A secondary effect or byproduct that arises from but does not causally influence a process.
Epiphenonom - secondary effect or byproduct that arises from but does not causally influence a process.
Epistolographer - A writer of epistles
Epoch - A period of time in history or a person's life, typically one marked by notable events or particular characteristics.
Eponymous - . (Of a person) Giving their name to something.2. (Of a thing) Named after a particular person.
Epyllion - A narrative poem that resembles an epic poem in style, but which is notably shorter.
Equable - (Of a person) Not easily disturbed or angered; calm and eventempered.
Errant - Erring or straying from the proper course or standards
Ersatz - A linen-finished gingham cloth with a white weft and a colored warp, producing a mottled appearance.
Erudite - having or showing great knowledge
Erumpent - (Biology) Bursting forth or through a surface
Eschew - Deliberately avoid using; abstain from.
Escritorie - a small writing desk
Escutcheon - metal keyhole, door handle, light plate
Espaciate - mental imagery take the form of inner feelings
Espicate - To find out by skill or laborious investigation.
Esprit de l'escalier - Used to refer to the fact that a witty remark or retort often comes to mind after the opportunity to make it has passed.
Estaminet - A small cafe in France that sells alcoholic drinks.
Estival - pertaining to summer
Ethnography - The scientific description of the customs of individual peoples and cultures
Eucasastophe - sudden and favorable ending to a story.
Eudaemonic - conducive to happiness
Eudaemonism - system of ethics that bases moral value on the likelihood of actions producing happiness.
Eunomy - equal law
Eupeptic - having good digestion
Euphony - The quality of being pleasing to the ear, especially through a harmonious combination of words.
Eurythmic - (Especially of architecture or art) In or relating to harmonious proportion.
Eustress - Moderate or normal psychological stress, interpreted as being beneficial.
Evanesce - Pass out of sight, memory, or existence.
Eventide - The end of the day.
Eventuate - occur as a result
Evince - reveal the presence of feelings or qualities
Excoriate - criticise (someone) severely.
Excursus - A detailed discussion of a particular point in a book, usually in an appendix.
Exemplum - An example or model, especially a moralising or illustrative story.
Exhortation - An address or communication emphatically urging someone to do something
Exigency - urgency of need
Exiguous - Very small in size or amount.
Exonumia - collecting coin like objects
Exonym - A name for a place or group of people that is only used outside that place or group.
Exoplanet - planet that orbits a star outside the solar system
Expound - explained in a detailed way
Extemporaneous - Spoken or done without preparation
Extemporize - Compose or perform something such as music or a speech without preparation; improvise.
Extramundane - Outside or beyond the physical world.
Extrospection - The observation of things external to one's own mind, as opposed to introspection.
Fabulation - a fabrication
Fabulist - a person who relates or composes fables
Factoid - A brief or trivial item of news or information.
Factotum - An employee who does all kinds of work.
Fain - pleased or willing under the circumstances
Fandangle - A useless or purely ornamental thing
Fantod - A state or attack of uneasiness or unreasonableness.
Fardel - a bundle
Farinaceous - Consisting of or containing starch.
Farrago - a confused mixture
Fartlek - runners training
Fascicle - A separately published instalment of a book or other printed work.
Fatuous - Silly and pointless
Favonian - Pertaining to the west wind.2. Mild, gentle.
Fecund - Producing or capable of producing an abundance of offspring or new growth; fertile.
feeling of contentment or well - being
Felicitate - Congratulate
Felicitous - Well chosen or suited to the circumstances
Feriation - holiday or cessation from work
Festoon - A chain or garland of flowers, leaves, or ribbons, hung in a curve as a decoration. A carved or molded ornament representing a festoon.
Fettle - condition
Fey - Giving an impression of vague unworldliness.
Fickle - Changing frequently, especially as regards one's loyalties or affections
Fictile - Made of earth or clay by a potter; relating to pottery or its manufacture.
Filial - Of or due from a son or daughter.(Biology) Denoting the generation or generations after the parental generation.
Fillip - Propel (a small object) with a flick of the finger.
first - person singular pronoun
Firstling - usually firstlings) The first agricultural produce or animal offspring of a season.
Flambeau - A flaming torch, especially one made of several thick wicks dipped in wax.
Flaneur - an idler or lounger
Flocculent - Having or resembling tufts of wool.
for an action").Aegis - The protection, backing, or support of a particular person or organization.2. (In classical art and mythology) An attribute of Zeus and Athena (or their Roman counterparts Jupiter and Minerva) usually represented as a goatskin shield.
Force majeure - Unforeseeable circumstances that prevent someone from fulfilling a contract.
Forenoon - The morning.
Forfend - keep away
Fossick - rummage or search
Fossorial - Burrowing, specifically related to animals.
Four square - Of a building or structure) Having a square shape and solid appearance.
Foursquare - having a square shape
Fracas - disturbance or noisy quarrel
Franglais - A form of French using many words and idioms borrowed from English.
Froideur - coolness or reserve between people
Frontispiece - An illustration facing the title page of a book.
Froward - (Of a person) Difficult to deal with; contrary.
Fugacious - tending to disappear.
Fulcrum - thing that plays a central or essential role in an activity, event, or situation
Fulgent - Shining brightly.
Fulsome - Complimentary or flattering to an excessive degree.
Funambulism - The art of walking on a tightrope or a slack-rope.
Funambulist - A tightrope walker
Funicular - cable railroad, especially one on a mountainside, in which ascending and descending cars are counterbalanced.
Furbelow - adorned with trimmings
Gadabout - habitual pleasure-seeker.
Gadarene - Involving or engaged in a headlong or potentially disastrous rush to do something.
Gainsay - dent or contradict a fact or statement
Galere - A group or coterie
Gallimaufry - A confused jumble or medley of things.2. A dish made from diced or minced meat, especially a hash or ragout.
Gallinaceous - Relating to birds of an order (Galliformes) which includes domestic poultry and game birds.
Gambol - An act of running or jumping about playfully.Rubescent-Reddening; blushing
Garniture - set of decorative accessories, in particular vases.
Gastronome - a gourmet
Gateau - A rich cake, typically one containing layers of cream or fruit.
Gauche - Lacking ease or grace; unsophisticated and socially awkward.
Gelastic - pertaining to laughter
Gelid - Icy; extremely cold.
Gemeinschaft - 1. Social relations between individuals, based on close personal and family ties; community.
Gemutlich - Pleasant and cheerful.
Georgic - A poem or book dealing with agriculture or rural topics.
Germane - Relevant to a subject under consideration.
Gesticulate - Use gestures, especially dramatic ones, instead of speaking or to emphasize one's words.
Gibbous - (Of the moon) Having the observable illuminated part greater than a semicircle and less than a circle.
Glebe - Land; Fields
Glib - insincere and shallow
Glyptic - Of or concerning carving or engraving.
Gnomic - Expressed in or of the nature of short, pithy maxims or aphorisms.
Gochugang - Korean spice
Gonzo - Relating to or denoting journalism of an exaggerated, subjective, and fictionalized style.2. Very strange or bizarre.
Gormandize - Eat good food, especially to excess.
Gossamer - A fine, filmy substance consisting of cobwebs spun by small spiders, seen especially in autumn.
Grabble - Feel or search with the hands; grope about
grabble - Feel or search with the hands; grope about
Grandiloquent - Pompous or extravagant in language, style, or manner, especially in a way that is intended to impress.
Grandisonant - Grand-sounding, giving the impression of grandeur; rhetorical
Granivorous - Of an animal) Feeding on grain. Toraska 1949 47 black
Gregarious - 1. (Of a person) Fond of company; sociable.2. (Of animals) Living in flocks or loosely organized communities.3. (Of plants) Growing in open clusters or in pure associations. Infusion: This is the broader term for steeping an ingredient (like fruit, herbs, spices, or botanicals) in a liquid (like alcohol, water, or oil) to transfer its flavors and aromas. When you make tea, you are infusing the tea leaves in hot water. In bartending and distilling, creating a flavored spirit is specifically called an infusion.
Grok - understand something
Guerdon - A reward or recompense
Gustatory - Concerned with tasting or the sense of taste.
Haberdasher - A dealer in men's clothing
Habitude - Habitual disposition or mode of behaviour or procedure.
Halcyon - Denoting a period of time in the past that was idyllically happy and peaceful or A mythical bird said by ancient writers to breed in a nest floating at sea at the winter solstice, charming the wind and waves into calm.
Hallux - big toe
Haptic - Relating to the sense of touch, in particular relating to the perception and manipulation of objects using the senses of touch and proprioception.
Harbinger - A person or thing that announces or signals the approach of another.2. A forerunner of something.
Hardscape - The human-made features used in landscape architecture, e.g., paths or walls, as contrasted with vegetation
Hearken - listen
Heffalump - A child's term for an elephant.
Hegemony - dominance
Heliacal - relating to or near the sun
Helicoid - An object of spiral or helical shape
Helicord - An object of spiral or helical shape
Heteroclite - abnormal or irregular
Heterodox - Not conforming with accepted or orthodox standards or beliefs.
Heuristic - Enabling someone to discover or learn something for themselves through methods such as experimentation, evaluation, and trial and error (Computing) Proceeding to a solution by trial and error or by rules that are only loosely defined. NOUN
Hibernian - concerning Ireland
Hippocrene - poetic or literary inspiration
Hirrient - a trill sound like a cat purring
Hispid - Botany and zoology) Covered with stiff hair or bristles.
Hoarfrost - A grayish-white crystalline deposit of frozen water vapor formed in clear still weather on vegetation, fences, etc.
Hoary - Grayish white
Hobbledehoy - A clumsy or awkward youth
Hoi polloi - the common people, the masses
Holograph - A manuscript handwritten by the person named as its author.
Homonymous - having the same namesake
Horripilation - The erection of hairs on the skin due to cold, fear, or excitement
Howbeit - Nevertheless; however.
Hubris - Excessive pride or self-confidence.2. (In Greek tragedy) Excessive pride toward or defiance of the gods, leading to nemesis.
Huckaback - A strong linen or cotton fabric with a rough surface, used for toweling
Hugger - Mugger- Confused; disorderly.2 secret or clandestine
Humectant - Retaining or preserving moisture.
Hyaline - Having a glassy, translucent appearance. Relating to, consisting of, or characterized by hyaline material
Hygge - quality of coziness and comfortable conviviality that engenders a
Hyperborean - inhabitant of the extreme north
Hypnogogic - Relating to the state immediately before falling asleep.
Hyponym - subordinates. A spoon is a hyponym of cutlery
Icarian - Relating to or characteristic of Icarus, especially in being excessively ambitious
Illation - The action of inferring or drawing a conclusion.
Immiscible - (Of liquids) Not forming a homogeneous mixture when added together.
Immutable - unable to be changed
Implacable - Unable to be placated.
Impress - A fund used by a business for small items of expenditure and restored to a fixed amount periodically.
Imprest - petty cash fund
Imprimatur - An official license by the Roman Catholic Church to print an ecclesiastical or religious book.2. A person's acceptance or guarantee that something is of a good standard.
Impute - represent (something, especially something undesirable) as being done, caused, or possessed by someone; attribute.
Incept - graduation with an academic degree
Inchoate - just begun, not fully formed. Incoherent
Incipient - In an initial stage; beginning to happen or develop.
Inconnu - an unknown person or object
Incredulity - state of being unwilling or unable to believe something.
Indite - write or compose
Indolent - lazy or without exertion
Ineffable - too great to be expressed in words
Infracaninophile - roots for the underdogs
Infrangible - Unbreakable; inviolable.
Inglenook - sides of a fireplace
Inimical - tending to obstruct or harm.
Inimitable - So good or unusual as to be impossible to copy; unique.
Iniquitous - Grossly unfair and morally wrong.
Inkhorn - a small portable container for ink
Innominate - Not named or classified
Inosculate - Join by intertwining or fitting closely together
insouciance - Casual lack of concern; indifference.
Insouciance - Casual lack of concern; indifference.
Insouciant - carefree
Inspirit - encouraged and inspired
Interrobang - A nonstandard punctuation mark (‽) indicating a question expressed in an exclamatory manner, as in "What are you doing‽"
Interstice - An intervening space, especially a very small one.
Invariable - Never Changing
Inveigle - Persuade (someone) to do something by means of deception or flattery.
Irascible - showing a tendency to be easily angered.
Irenic - aimed at peace
Irrefragable - Not able to be refuted or disproved; indisputable.
Isochronous - Occurring at the same time
Isopolity - rights across different groups and regions
Izzat - Honor, reputation, or prestige.
Jacoserious - being jocular and serious at the same time. Mixing mirth and seriousness
Jocose - playful
Jocoserious - Simultaneously jocular and serious; mixing mirth with serious matters.
Judas hole - one way spy hole at a church.
Judder - Especially of something mechanical) shake and vibrate rapidly and with force.
Juggernaut - A huge, powerful, and overwhelming force or institution
Juvenilia - Works produced by an author or artist while still young.
J’adobe - A declaration by a player intending to adjust the placing of a chessman without making a move with it.
Kaffeekelatseh - An informal social gathering at which coffee is served2. Talking or gossip at an informal gathering where coffee is served.
Kawaii - In Japanese popular culture) Appealing in an endearing way; cute.
Kenspeckle - Easily recognizable; conspicuous
Kerfuffle - A commotion or fuss, especially one caused by conflicting views
Kine - Cows collectively
Kinesis - motion
Kinetic - Relating to or resulting from motion.
Kirschwasser - Brandy distilled from the fermented juice of cherries.
Kludge - assorted parts
Knurl - A small projecting knob or ridge, especially in a series around the edge of something
Korero - A conversation, discussion, or meeting
Labellum - (Botany) A central petal at the base of an orchid flower, typically larger than the other petals and of a different shape.
Labile - emotionally unstable
Lability - ease of alteration or change
Lacertilian - lizard like
Lacuna - An unfilled space or interval; a gap
Lagniappe - something given as a bonus or gift
Lagom - trying to achieve balance in one’s life
Lagomorph - A mammal of the order Lagomorpha; a hare, rabbit, or pika
Lambent - Of light or fire) Glowing, gleaming, or flickering with a soft radiance.
Langsettle - A long wooden seat, a precursor of the sofa.
Largesse - Generosity in bestowing money or gifts upon others.
Lascivious - showing strong sexual desire
Layette - A set of clothing, linens, and sometimes toiletries, for a newborn.
Legatees - a person who receives a legacy.
Lenticular - ufo shaped
Leonine - Of or resembling a lion or lions.
Lethologica - The inability to remember a particular word or name.
Liaise - Establish a working relationship, typically in order to cooperate on a matter of mutual concern.
Librate - Oscillate or seem to oscillate.
Licentious - lacking sexual restraint
Lief - happily or gladly
lighthearted medley of well - known tunes.
Lightsome - Merry and carefree
Limitrophe - Border, frontier; being or existing along a border or frontier.
Limpet - A marine mollusk which has a shallow conical shell and a broad muscular foot, found clinging tightly to rocks.
Limpid - Free of anything that darkens; completely clear.
Lissome - (Of a person or their body) Thin, supple, and graceful.
Lithology - The study of the general physical characteristics of rocks. Or The general physical characteristics of a rock or the rocks in a particular area.
Litigious - unreasonably prone to go to law to settle disputes.
Logomachy - An argument about words.
Logorrhea - A tendency to extreme loquacity
Loguacious - talkativeness
Logy - Dull and heavy in motion or thought; sluggish.
Longanimity - Patience or tolerance in the face of adversity; forbearance, longsuffering.
Loquacious - Tending to talk a great deal; talkative.
Loricate - animals protective breastplate
Louche - questionable taste or morality
Lucubrate - Write or study, especially by night.
Ludic - Showing spontaneous and undirected playfulness.
Lugrubrious - looking or sounding sad and dismal.
Lyceum - A literary institution, lecture hall, or teaching place.
maceration - The process of soaking fruits or herbs in spirits to create unique flavors
Macguffin - An object or device in a movie or a book that serves merely as a trigger for the plot.
Macroscopic - Visible to the naked eye; not microscopic.
Magniloquent - Using high-flown or bombastic language
Mahalo - (Mainly in Hawaii) Used to express gratitude.
Majuscule - Large lettering, either capital or uncial, in which all the letters are the same height.
Makebate - One that excites contentions and quarrels.
Malapropism - The mistaken use of a word in place of a similar-sounding one, often with unintentionally amusing effect, as in, for example, "dance a flamingo" (instead of flamenco.
Malheureusement - Unfortunately
Malic - Pertaining to apples
Mamducate - Chew or eat
Manchet - A loaf of the finest kind of wheat bread.
Manifico - An eminent, powerful, or illustrious person.
Manifold - Many and various.
Mansuetude - gentleness, meekness
Marmoreal - Made of or likened to marble.
Matronymic - name derived from a female ancestor
Matutinal - Of or occurring in the morning.
Maunder - to talk in a rambling manner
Meed - a deserved reward
Melange - mixture; a medley
Meliorism - The belief that the world can be made better by human effort.
Melisma - musical onomatopoeia
Melliferous - Yielding or producing honey
Memoriter - memory; by heart
Mendacious - not telling the truth, lying.
Mentation - Mental activity.
Mephitic - Especially of a gas or vapor) Foul-smelling; noxious.
Mercurial - (Of a person) Subject to sudden or unpredictable changes of mood or mind.
Metanoia - Change in one's way of life resulting from penitence or spiritual conversion
Mezzanine - A low story between two others in a building, typically between the ground and first floors. "
Miasma - highly unpleasant or unhealthy smell or vapor.2. An oppressive or unpleasant atmosphere which surrounds or emanates from something.
Micawberish - Resembling the character Wilkins Micawber in Charles Dickens' novel “David Copperfield,” especially in being irresponsibly optimistic.
Mickle - A large amount
Mien - a persons look or manner
Milieu - a persons social environment
Minim - (Music, British) A note having the time value of two quarter notes or half of a whole note, represented by a ring with a stem. Also called half note.
Mirific - Working wonders; wonderful.
Mirth - Amusement, especially as expressed in laughter.
Miscellany - a mixture
Mise en Place - (In a professional kitchen) The preparation of dishes and ingredients before the beginning of service.
Misophonia - reaction to tedious sounds
mitigation - the action of reducing the severity
Moiety - a part or a portion, usually smaller
Moil - Work Hard
Mollify - Appease the anger or anxiety of (someone).
Monad - from Greek monas “unit”), an elementary individual substance that reflects the order of the world and from which material properties are derived
Mononym - persons name without last name. Example, sting, Madonna, bono etc
Monopsony - one buyer
Monosemy - property of having only one meaning.
Moppet - A small endearingly sweet child.
Moue - A pouting expression used to convey annoyance or distaste.
Moxie - force of character
Mugwump - someone who stays all of from party politics
Mulct - Extract money from (someone) by fine or taxation
Muliebrity - Womanly qualities; womanhood.
Multivocal - Having or open to many different meanings, interpretations, or applications.
Mycology - The scientific study of fungi.
Nadir - The lowest point in the fortunes of a person or organisation.(Astronomy) The point on the celestial sphere directly below an observer. The opposite of "zenith.
Nainsook - A fine, soft cotton fabric, originally from South Asia
Napery - Household linen, especially tablecloths and napkins.
Nascent - Especially of a process or organization) Just coming into existence and beginning to display signs of future potential.
Natation - Swimming
Natty - person or an article of clothing) Smart and fashionable
Neep - turnip
Neophobia - Love of, preference for, or great interest in what is new.
Neophyte - A person who is new to a subject, skill, or belief.
Neotetic - new or modern
Nicatitation - winking, blinking
Nictate - blink
Nidification - nest building
Nimbus - A luminous cloud or a halo surrounding a supernatural being or a saint.2. A light, color, etc., that surrounds someone or something.3. A large gray rain cloud.
Nisus - A mental or physical effort to attain a specific goal; a striving.
Noblessoblige - the quality of being kind and generous.
Nodus - problem, difficulty, or complication
Noetic - the intellect
Noisome - having an offensive smell, unpleasant
Nonage - The period of immaturity or youth
Nonpareil - An unrivalled or matchless person or thing.
Nosegay - A small bunch of flowers, typically one that is sweet-scented
Nosism - The use of a first-person plural pronoun (such as "we") instead of a
Notaphily - collecting bank notes as a hobby
Notional - Existing only in theory or as a suggestion or idea.2. Existing only in the imagination.
Nugacity - Triviality or frivolity.
Nugatory - useless or futile, of no value
Numismatic - Relating to or consisting of coins, paper currency, and medals.
Nyctalopia - The inability to see in dim light or at night. Also called night blindness
Obdurate - stubbornly refusing to changes one’s opinion
Obfuscate - to make something confusing or unclear
Obnubilate - Darken, dim, or cover with or as if with a cloud; obscure.
Obstreperous - noisy and difficult to control
Obtund - Dull the sensitivity of; blunt; deaden.
Ocher - A pale brownish yellow color.
Oddment - Usually "oddments") A remnant or part of something, typically left over from a larger piece or set.
Odious - repulsive
Oenophile - A connoisseur of wines
Oeuvre - The works of a painter, composer, or author regarded collective
Ogdaod - A group or set of eight
Ogdoad - set or group of 8
Olivaceous - Of a dusky yellowish green color; olive green.
Omnifarious - Comprising or relating to all sorts or varieties.
Omphaloskepsis - navel gazing
Ontic - Relating to entities and the facts about them; relating to real as opposed to phenomenal existence
Oology - The study or collecting of birds' eggs.
Operose - Involving or displaying much industry or effort.
Ophidian - A resident of a town
Oppugn - call into questions the validity
Opsigamy - marriage at an older age
Opsimath - A person who begins to learn or study only late in life.
Opuscule - a small literary or musical work
Orchidaceous - Relating to or denoting plants of the orchid family
Organza - A thin, stiff, transparent fabric made of silk or a synthetic yarn.
Orrery - planetarium consisting of an apparatus that illustrates the relative positions and motions of bodies in the solar system by rotation and revolution of balls moved by wheel work; sometimes incorporated in a clock.
Orthography - The conventional spelling system of a language.2.The study of spelling and how letters combine to represent sounds and form words.
Oscillating - Move or swing back and forth at a regular speed.
Ostracon - A potsherd used as a writing surface.
Otiose - Serving no practical purpose or result.2. Indolent; idle.
Oxfordian - Relating to or denoting the theory that Edward de Vere (1550– 1604), Earl of Oxford, wrote the plays attributed to Shakespeare.
Pablum - bland or insipid intellectual fare, entertainment, etc.; pap.
Paladin - A knight renowned for heroism and chivalry
Palaeography - The study of ancient writing systems and the deciphering and dating of historical manuscripts.
Palfrey - A docile horse used for ordinary riding.
Palindrome - A word, phrase, or sequence that reads the same backward as forward, e.g., "madam" or "nurses run."
Palinode - A poem in which the poet retracts a view or sentiment expressed in a former poem.
Palmary - Worthy of the palm; preeminent; superior
Panacea - a remedy for all difficulties
Panache - Flamboyant confidence of style or manner.
Pandowdy - deep dish apple pie
Panegyric - A public speech or published text in praise of someone or something.
Pangloss - optimistic
Pannier - A basket, especially one of a pair carried by a beast of burden. 2. Each of a pair of bags or boxes fitted on either side of the rear wheel of a bicycle or motorcycle.3. Part of a skirt looped up around the hips.4. A frame supporting a pannier of a skirt.
Pantheon - A group of particularly respected, famous, or important people.
Pantophagous - Eating all kinds or a great variety of food.
Pantophagus - eating a variety of foods
Par Excellence - Better or more than all others of the same kind.
Paracme - A point beyond the highest or greatest.
Paradigm - A typical example or pattern of something; a model.
Paragon - A perfect diamond of 100 carats or more.
Paramecia - genus of slipper-shaped, ciliate protozoa
Paraph - a flourish after a signature as a c’precaution against forgery.
Parapraxis - Freudian slip, minor error in action or speech
Paripatetic - Traveling from place to place, in particular working or based in various places for relatively short periods. 2. (Peripatetic) Aristotelian. [With reference to Aristotle's practice of walking to and fro while teaching
Parisology - The use of Equivocal ambiguous words
Parol - given or expressed orally
Paroxysm - sudden attack or violent expression of a particular emotion or activity.
Parsimonious - unwilling to use resources or spend money
Passé - partout- master key
Pastiche - An artistic work in a style that imitates that of another work, artist, or period.
Patois - The dialect of the common people of a region, differing in various respects from the standard language of the rest of the country.2. The jargon or informal speech used by a particular social group.
Patrilineal - Relating to or based on relationship to the father or descent through the male line.
Patulous - (Especially of the branches of a tree) Spreading.
Peat - A brown deposit resembling soil, formed by the partial decomposition of vegetable matter in the wet acidic conditions of bogs and fens, and often cut out and dried for use as fuel and in gardening.
Pedagogue - Formal, humorous) A teacher, especially a strict or pedantic one.
Pedant - someone who shows off learning
Pelagic - Relating to the open sea
Pellucid - Translucently clear.
Pelota - A Basque or Spanish game played in a walled court with a ball and
Pensile - hanging down
Pentimento - A visible trace of earlier painting beneath a layer or layers of paint on a canvas.
Penumbra - The partially illuminated outer part of a shadow created by a solid object
Perdurable - Enduring continuously; imperishable.
Perfidy - the state of being deceitful and untrustworthy.
Pergola - an archway
Pericope - An extract from a text, especially a passage from the Bible.
Peripatetic - a person who travels place to place or a philosopher of Aristotle
Peripeteia - A sudden reversal of fortune or change in circumstances, especially in reference to fictional narrative.
Pernicious - Harmful or destructive
Perorate - Speak at length.
Persiflage - Light and slightly contemptuous mockery or banter.
Personalia - All the personal belongings, writings and information of an individual.
Perspicacious - Having a ready insight into and understanding of things
Pervicacity - (Obsolete) Obstinacy; pervicaciousness.
Pescatarian - A person who does not eat meat but does eat fish.
Petrichor - 1. A pleasant smell that frequently accompanies the first rain after a long period of warm, dry weather
Phalanx - A group of people or things of a similar type forming a compact body.
Phalynx - body of troops or police officers standing or moving in close formation.
Phantasmagoria - A sequence of real or imaginary images like those seen in a dream.
Philately - the collection and study of postage stamps
Philter - a love potion
Phlegmatic - Of a person) Having an unemotional and stolidly calm disposition.
Phoenicopter - (archaic) A flamingo.
Phrontistery - a place to think
Picaresque - Relating to an episodic style of fiction dealing with the adventures of a rough and dishonest but appealing hero.
Pickwickian - jovial, plump, or generous.Misunderstood or misused; not literally meant, especially to avoid offense.
Piffling - Trivial; unimportant.
Pinnate - leaves on branches,leaves on both sides, Feathers have a pinnate, symmetrical structure."
Pinniped - seal
Pinochle - players using a 48-card deck consisting of two of each card from nine to ace, the object being to score points for various combinations and to win tricks.
Pinole - A sweetened flour made from ground dried corn mixed with flour made of mesquite beans, sugar, and spices.
Piquant - Having a pleasantly sharp taste or appetizing flavor.
Piscatorial - having to do with fishing
Pisher - an insignificant or contemptible person
Pithy - vigorously expressive, terse
Plage - a resort by the beach
Plangent - Mainly literary) (of a sound) loud, reverberating, and often melancholy
Pleach - Entwine or interlace (tree branches) to form a hedge or provide cover for an outdoor walkway.
Plenilune - the time of a full moon
Plentilune - a full moon
Plutography - coverage of the rich
Pococurante - indifferent,apathetic. Nonchalant
Pollex - The innermost digit of a forelimb, especially the thumb in primates.
Polychrome - The art of painting in several colors, especially as applied to ancient pottery, sculpture, and architecture.
Polyhistor - Another term for polymath (a person of wide-ranging knowledge or learning).
Portage - Carry (a boat or its cargo) between navigable waters.
Portmanteau - combines the words “breakfast” and “lunch” in a delectable combination that denotes the meal that occurs in late morning or early afternoon
Potation - The action of drinking alcohol.
Pother - A commotion or fuss
Potsherd - a ceramic tablet
Pourboire - A gratuity; a tip.
Praxis - Practice, as distinguished from theory.Accepted practice or custom.
Precatory - Relating to or expressing a wish or request.In a will) Expressing a wish or intention of the testator.
Precis - A summary or abstract of a text or speech.
Prehensile - grabbing of an animals tail
Premafacie - based on first impressions
Prepense - deliberate
Preponderance - The quality or fact of being greater in number, quantity, or importance
Prepone - To reschedule to a time earlier than the current scheduled time.
Prepossessing - Attractive or appealing in appearance.
Preprandial - taken before a meal
Prescind - Leave out of consideration
Pret a porter - (Of designer clothes) Sold ready-to-wear as opposed to made to measure.
Primacy - The fact of being primary, preeminent, or more important.2. The office, period of office, or authority of a primate of certain churches.3. (Psychology) The fact of an item having been presented earlier to the subject (especially as increasing its likelihood of being remembered).
Prink - Spend time making minor adjustments to one's appearance; primp.
Proboscis - The nose of a mammal, especially when it is long and mobile such as the trunk of an elephant or the snout of a tapir.
Proficious - profitable
Proficuous - Useful or profitable
Profundity - Deep insight; great depth of knowledge or thought.2. Great depth or intensity of a state, quality, or emotion.
Prolepsis - addressing comments rhetorically
Pronk - (Of a springbok or other antelope) Leap in the air with an arched back and stiff legs, typically as a form of display or when threatened.
Prorogue - Discontinue a session of (a parliament or other legislative assembly) without dissolving it.2. (Of a legislative assembly) Be discontinued without being dissolved.
Prosaic - ordinary and not especially interesting or unusual
Prosopography - description of a person's social and family connections, career, etc., or a collection of such descriptions.
Prospicience - Foresight.
Protean - versatile, able to change frequently
Provenance - origin or record of ownership
Psionic - relating to the practical use of psychic powers
Puerile - Childishly silly and trivial Convalescence
Pugilism - the profession or hobby of boxing.
Puissant - Having great power or influence
Pulchritude - Beauty
Punctilious - showing great attention to detail or correct behavior
Pungle - to hand out, to shell out
Punnet - small basket of fruit or vegetables
Purlieu - The area near or surrounding a place.2. A person's usual haunts.
Quaesitum - omething sought or required.
Quark - Physics) Any of a number of subatomic particles carrying a fractional electric charge, postulated as building blocks of the hadrons. Quarks have not been directly observed but theoretical predictions based on their existence have been confirmed experimentally.
Queenly - Fit for or appropriate to a queen
Quiddity - The inherent nature or essence of someone or something or A distinctive feature; a peculiarity.
Quidnuc - a gossipy person
Quinquennial - Recurring every five years; lasting for or relating to a period of five years.
Quiscquous - hard to deal with;dubious
Quixotic - unrealistic, unrealistically idealist,impractical
Quodlibet - lighthearted medley of well-known tunes.
Raconteur - A person who tells anecdotes in a skillful and amusing way.
Raffine’ - Refined, sophisticated.
Raillery - Good-humored teasing.
Raison d'ê·tre - the most important reason for someone or something’s existence
Raisonneur - person in a play or book embodying an author's voice
Rapproche - an establishment or reestablishment of harmonious relations: a rapprochement reached between warring factions.
Ratiocinate - Form judgments by a process of logic; reason.
Realia - Objects and material from everyday life, especially when used as teaching aids
Reboant - That reverberates or resounds loudly.
Recherche - Rare, exotic, or obscure.
Recompense - make amends to someone
Rede - Advise (someone).
Redolent - Strongly reminiscent or suggestive of (something).
Refection - A meal, especially a light one
Regent - person appointed to administer a country because the monarch is a minor or is absent or incapacitated
Reify - make something abstract more real
Rejoinder - A reply, especially a sharp or witty one.
Reliquary - container for holy relics
Remontant - planting more than once a season
Renascent - becoming popular again
Renunciation - to reject
Repartee - Conversation or speech characterised by quick, witty comments or replies.
Repetend - A recurring word or phrase; a refrain
Residuum - something that is left behind. A residue
Resile - abandon a position
Resipiscence - acknowledging a wrong while promising to better in the future
Retroject - project backwards
Retrousse - Of a person's nose) Turned up at the tip in an attractive way.
Rhapsody - An effusively enthusiastic or ecstatic expression of feeling.
Rhonchisonant - Making a snorting noise; snorting.
Rifacimento - A literary work or musical composition recast to adapt it to a change in the circumstances of the time
Rigamarole - a lengthy and complicated process
Rigorism - Extreme strictness in interpreting or enforcing a law, precept, or principle
Rime - cover with frost
Ripper - Australian) A thing that is particularly admirable or excellent
Risible - provoke to laughter
Rivage - A coast; a shore.
Rodomontade - boastful
Roister - Enjoy oneself or celebrate in a noisy or boisterous way.
Roman a clef - real persons and events are overlaid with fictional persons and events. (Story with a key)
Roseate - Rose-colored.2. Used in names of birds with partly pink plumage, e.g., roseate tern, roseate spoonbill. 3. Optimistic or idealistic.
Rotiferous - producing dew
Rubicund - Especially of someone's face) Having a ruddy complexion; highcolored.
Rufous - reddish brown color
Rum - boisterous- boisterous or unruly
Rumbustious - Boisterous or unruly.
Rupestrian - Of art) Done on rock or cave walls.
Ruthful - Full of sorrow; sorrowful; woeful;
Rutilent - glowing and glittering with red or golden light
Sabkha - An area of coastal flats subject to periodic flooding and evaporation, which result in the accumulation of aeolian clays, evaporites, and salts, found in North Africa and Arabia.
Sabulous - Sandy or gritty.
Sachet - A small perfumed bag used to scent clothes.
Sagacious - Having or showing keen mental discernment and good judgment.
Salmagundi - a mixture. A miscellaneous collection
Salubrious - Health-giving; healthy.
Sanative - Conducive to physical or spiritual health and well-being; healing.
Sanctimonious - acting morally superior to other people
Sanguine - optimistic in a bad situation, blood red
Sapid - Having a strong, pleasant taste
Sapient - Formal) Wise, or attempting to appear wise. (Chiefly in science fiction) Intelligent.
Saturnine - slow and gloomy
Saudade - Brazilian or Portuguese nostalgia or longing
savant - A very learned or talented person, especially one distinguished in a particular field of science or the arts.
Scalene - (Of a triangle) Having sides unequal in length.
Scantling - A specimen, sample, or small amount of something.
Scaramouch - A boastful but cowardly person.
Schneid - Gin rummy) A loss with no points scored.
Schuss - A straight downhill run on skis.
Scintilla - tiny trace or spark of a specified quality or feeling.
Scintillation - flash or spark of light
Sciolist - a person who pretends to be an expert on a subject but knows very little
Scion - offshoot
Scission - a cut or cutting
Scuttlebutt - Rumor; gossip.
Sedulous - showing dedication
Sehnsucht - Yearning; wistful longing
Selvage - An edge produced on woven fabric during manufacture that prevents it from unraveling.
Semiquaver - a sixteen note
Sensate - Perceiving or perceived by the senses.
Sensu lato - in the broad sense
Sequela - A condition which is the consequence of a previous disease or injury.
Seraphic - blissful or angelic in appearance
Seriocomic - Combining the serious and the comic; serious in intention but jocular in manner or vice versa
Sesquipedalian - Characterized by long words; long-winded.
Shambolic - Chaotic, disorganized, or mismanaged.
Sheepshank - A kind of knot used to shorten a rope temporarily.
Shellback - An old or experienced sailor, especially one who has crossed the equator.
Sibilate - Utter with a hissing sound.
Silt - fine sand
Simpatico - Having or characterized by shared attributes or interests; compatible
Simulacrum - An image or representation of someone or something or An unsatisfactory imitation or substitute.
Sinecure - position requiring little or no work but giving the holder status or financial benefit.
Sitooterie - A small patio or sheltered area outside a house, suitable for sitting in for relaxation or socializing
Sitzfleisch - A person's buttocks..Power to endure or to persevere in an activity; staying power.
Sitzfliesch - the buttocks
Skeuomorph - An object or feature which imitates the design of a similar artifact made from another material.2. (Computing) An element of a graphical user interface which mimics a physical object.
Skirr - Move rapidly, especially with a whirring sound.
Smorzando - music as a direction that fades
Snollygoster - A shrewd, unprincipled person, especially a politician.
Sobriquet - A person's nickname.
Sockdolager - An exceptional person or thing
Soi - disant-Self-styled; so-called.
Soigne - Dressed very elegantly; well groomed.(swan-ya)
Solatium - Formal) A thing given to someone as a compensation or consolation.
Solipsism - The quality of being very self-centered or selfish.
Solipsistic - self centered
Solon - A wise legislator or lawgiver.
Solus - alone or unaccompanied as in stage direction
Sororal - Of or like a sister or sisters.
Sough - A moaning, whistling, or rushing sound as made by the wind in the trees or the sea.
Speciate - into a new and distinct species in the course of evolution.
Spindrift - spray from wind blowing wave crests
Spizzerinctum - determination,ardor,zeal
Spoor - track or scent of an animal
Sprag - small piece of wood or timber
Sprechaesang - a style of dramatic vocalization between speech and song
Spurious - false or fake
Stalwart - Loyal, reliable, and hardworking
Stanchion - sturdy upright fixture used as a velvet rope line at a club
Stellate - radiating in a star like pattern
Stemwinder - a rousing and entertaining speech
Stentorian - (Of a person's voice) Loud and powerful.
Sternutation - the act of sneezing.
Sthenic - Of or having a high or excessive level of strength and energy.
Stochastic - Randomly determined; having a random probability distribution or pattern that may be analyzed statistically but may not be predicted precisely.
Stravaig - Wander about aimlessly
Subjugation - bring someone or something under control or dominance Plasma Wakefield constant
Sublunary - belonging to this world as contrasted with a better one or more spiritual one.
Submontane - Passing under or through mountains.
Subsume - Include or absorb (something) in something else.Esprit de corpsfeeling of pride, fellowship, and common loyalty shared by the members of a particular group.
Succedaenum - medical substitute
Succor - assistance and support in times of hardship and distress.
Superannuated - to old to use
Supererogation - The performance of more work than duty requires
Superficies - surface or outward part
Supersedence - taking the place off or replacing
Supine - lying face up
Surfeit - excessive amount of something
Suspire - breathe
Susurrus - whispering, rustling.murmuring
Swain - A young lover or suitor.
Sward - An expanse of short grass.2. The upper layer of soil, especially when covered with grass.
Sybarite - a person who is self-indulgent in their fondness for sensuous luxury.
Synchronicity - The simultaneous occurrence of events which appear significantly related but have no discernible causal connection.
Syncretic - Combining disparate elements in one system, especially as in forms of religious observance, philosophical systems, or artistic creations.
Synecdoche - an expression that uses a part to stand for a whole. For instance, "wheels" represents a whole car
Taciturn - saying little
Talisman - An object, typically an inscribed ring or stone, that is thought to have magic powers and to bring good luck
Talmudic - of or pertaining to the Talmud
Tantivy - A rapid gallop or ride. (Exclamation) Used as a hunting cry.
Taradiddle - a petty lie or pretentious nonsense
Tastevin - A small, shallow silver cup for tasting wines, of a type used in France
Taxonomy - the classification of something
Telic - a goal
Tellurian - inhabiting the earth
Telos - An ultimate object or aim
Tenebrous - Dark; shadowy or obscure
Tensile - Relating to tension.
Tergiversation - The act of abandoning something or someone, of changing sides; desertion.
Terminus - A final point in space or time; an end or extremity.
Terpsichorean - related to dancing
Terraqueous - consisting or formed of land and water.
Terse - abruptly, sparing use of words
Tertiary - third in order or a special medical treatment
Tessellate - Decorate or cover (a surface) with a pattern of repeated shapes, especially polygons, that fit together closely without gaps or overlapping.
Tetrachromacy - condition of possessing four independent channels for conveying color information, or possessing four types of cone cell in the eye
Thrall - having great power over someone
Tiffin - light meal or lunch
Timorousness - Showing or suffering from nervousness or a lack of confidence
Tinctorial - elating to dyeing, coloring, or staining properties.
Tintinnabulation - a ringing or tingling sound
Tittle - a small amount of something
Tittup - jerky movements
Tocsin - an alarm or bell
Tohubohu - A state of chaos; utter confusion
Toothsome - tempting tasty
Tootle - leisurely travel, Casually make a series of sounds on a horn, trumpet, or similar instrument.
Toponym - A place name, especially one derived from a topological feature
Torpid - lethargic
Torschlusspanik - The fear that time to act is running out.
Tortuous - Full of twists and turns.
Totem - A natural object or animal that is believed by a particular society to have spiritual significance and that is adopted by it as an emblem.2. A person or thing regarded as being symbolic or representative of a particular quality or concept.
Tourbillion - Any part of a machine with a spiral movement.
Trade - last- A compliment from a third person that is relayed to the person complimented in exchange for a similarly relayed compliment.
Tralatitious - metaphorical
Transmogrify - Transform in a surprising or magical manner.
Transmute - change in form, nature or substance
Transpicuous - Transparent.
Travailous - Causing or involving travail; laborious; toilsome
Treacle - (British English) A thick, sticky dark syrup made from partly refined sugar; molasses.2. Cloying sentimentality or flattery.
Trenchant - 1. Vigorous or incisive in expression or style.2. (Of a weapon or tool) Having a sharp edge.
Trichromatic - having or using three colors
Triplicity - Group of three
Triptych - A picture or relief carving on three panels, typically hinged together side by side and used as an altarpiece.
Tropism - (Biology) The turning of all or part of an organism in a particular direction in response to an external stimulus
Trove - A store of valuable or delightful things.
Truncal - Of or affecting the trunk of the body, or of a nerve.
Tsundoku - collecting books and not reading them.
Turbid - 1. (Of a liquid) Cloudy, opaque, or thick with suspended matter. 2. Confused or obscure in meaning or effect.
Tutelary - a guardian
Twee - Excessively or affectedly quaint, pretty, or sentimental.
Twitterpated - Infatuated or obsessed.
Tyro - . A beginner or novice.
Ullage - Loss of liquid, by evaporation or leakage.
Ultracrepidarian - Expressing opinions on matters outside the scope of one's knowledge or expertise
Ultroneous - Spontaneous; voluntary.
Umbriferous - casting a shade
Uroboros - circular symbol depicting a snake, or less commonly a dragon, swallowing its tail, as an emblem of wholeness or infinity
Uxorious - Having or showing an excessive or submissive fondness for one's wife.
Vagile - (Biology) Free to move about.
Valediction - The action of saying farewell.
Velocious - rapid or fast
Verdant - Green with grass or other rich vegetation.
Verdigris - A bright bluish-green encrustation or patina formed on copper or brass by atmospheric oxidation, consisting of basic copper carbonate.
Veridical - Truthful.
Verisimilitude - the appearance of being real or true
Vernal - Of, in, or appropriate to spring.
Versant - A region of land sloping in one general direction.
Verve - 1. Vigor and spirit or enthusiasm.
Viand - meat, seafood, or vegetable dish that accompanies rice in a typical Filipino meal.
Viator - traveler, wanderer
Vibrissae - mammal whiskers
Vicinal - neighbour , adjacent atoms in a chemical Charente
Vicissitude - change of circumstances
Videlicet - more formal “viz” ,used to introduce a gloss or explanation
Vigesimal - Relating to or based on the number twenty.
Vigneron - A person who cultivates grapes for winemaking.
Virtu - Knowledge of or expertise in the fine arts.Literary) The good qualities inherent in a person or thing.
Visage - A person's facial expression.
Visagiste - A makeup artist
Vistagiste - a make up artist
Vociferous - vehement or clamourous
Volplane - (Of an airplane) Make a controlled dive or downward flight, especially with the engine shut off
Vulgate - commonly recognized text or edition, as of the "Iliad. 2. (In singular) Common or colloquial speech.
Vulpine - relating to a fox or foxes
Waggish - facetious, funny, mischievous
Wangle - An act or an instance of obtaining something by persuasion or clever manipulation.
Wayfarer - a person who travels on foot
Wheeple - a shrill cry
Whetstone - A fine-grained stone used for sharpening cutting tools.
Widdershins - In a direction contrary to the sun's course, considered as unlucky; counterclockwise.
Winkle - extract
Winnow - Blow a current of air through (grain) in order to remove the chaff.
Winsome - Attractive or appealing in appearance or character.
Withal - a further fact for consideration
Wonted - Habitual; usual.
Woodshed - To practice a musical instrument.
Wunderkind - a person who achieves success early
Xeric - very dry environment
Yarborough - a card hand with nothing greater than a 9 when playing bridge or whist
Yare - Of a ship) Responding promptly to the helm; easily manageable.
Yegg - safecracker
Yggdrasil - tree of life, huge ash tree located at the center of the earth, with three roots, one extending to Niflheim (the underworld), one to Jotunheim (land of the giants), and one to Asgard (land of the gods).
Zaftig - plump
Zenith - The time at which something is most powerful or successful.
Zenzic - Relating to the square of a number.
Zephyr - a soft gentle breeze
Zeroth - presiding the first in a series
Zetetic - Proceeding by inquiry
Ziggurat - (In ancient Mesopotamia) A rectangular stepped tower, sometimes surmounted by a temple. Ziggurats are first attested in the late 3rd millennium BC and probably inspired the biblical story of the Tower of Babel (Gen. 11:1–9).
Zonk - Fall or cause to fall suddenly and heavily asleep or lose consciousness.
Zwieback - A rusk or cracker made by baking a small loaf and then toasting slices until they are dry and crisp.
Zymurgy - The study or practice of fermentation in brewing, winemaking, or distilling.
